##########
#        #
#        #
#        #
#     ####
#     #   
#     ####
# PXO  ###
#        #
# OX     #
##########