##########
#        #
#        #
#        #
#        #
#        #
#        #
# PXO  ###
#        #
# OX     #
##########